 _______
|    ___  |
|  __     |
|  _    |_|
| |       |
|S|_____|U|
360
